16 13
07 05 05 05 05 05 05 05 05 05 05 05 05 05 05 05
04 00 00 00 00 00 00 00 00 00 00 00 00 00 00 01
04 00 00 00 00 00 00 00 00 00 00 00 00 00 00 02
04 00 01 01 00 00 01 00 00 00 00 00 00 00 00 03
04 00 00 00 00 00 00 00 00 00 00 00 00 00 00 00
04 00 00 00 00 00 00 00 00 00 00 00 00 00 00 00
04 00 00 00 00 00 00 00 00 00 00 00 00 00 00 00
04 00 00 00 00 00 01 00 00 00 00 00 00 00 00 00
04 00 00 00 00 00 00 00 00 00 00 00 00 00 00 00
04 00 00 00 00 00 00 00 00 00 00 00 00 00 00 00
04 00 00 00 00 00 10 00 00 00 00 00 00 00 00 00
06 05 05 05 05 05 05 05 05 05 05 05 05 05 05 05
