16 13 13 13 13 13 13 13 13 17 16 13 13 13 13 13 13 13 13 13 13 13 13 17
23 6 6 6 6 6 6 6 6 15 12 6 6 6 6 7 7 7 7 6 6 6 6 15
6 6 6 6 6 6 6 6 6 15 12 6 4 6 6 6 6 6 6 6 6 6 6 15
21 6 7 6 6 6 7 6 6 15 12 6 6 6 6 6 6 6 6 6 5 6 6 15
12 6 6 6 6 6 6 6 6 15 19 14 14 14 14 21 6 6 6 6 6 6 6 15
12 6 6 6 6 6 6 6 6 22 13 13 13 13 13 23 6 6 6 6 6 6 6 15
12 6 6 6 6 6 6 6 6 6 6 6 6 6 6 6 6 6 6 6 6 6 6 15
12 6 6 6 6 5 6 6 6 6 6 6 6 6 6 6 6 6 6 6 6 6 6 15
12 6 6 7 6 6 6 6 6 6 6 6 6 6 6 6 6 20 14 14 14 14 14 18
12 6 6 6 7 6 6 6 6 6 6 6 6 6 6 6 6 15 16 13 13 13 13 17
12 6 6 6 6 6 6 6 6 6 6 7 6 6 6 6 6 15 12 6 6 6 6 15
12 6 6 6 6 6 6 6 6 6 6 6 6 6 6 6 6 15 12 6 6 6 6 15
12 6 6 6 6 6 9 6 6 6 6 5 20 14 21 6 6 15 12 6 6 6 6 20
12 6 6 6 6 6 6 6 6 6 6 6 15 2 19 14 14 18 12 6 6 6 6 15
12 6 6 6 6 6 6 6 6 6 6 6 15 3 16 13 13 17 12 6 5 7 6 15
12 6 6 6 6 6 6 6 6 6 6 6 22 13 23 4 6 15 12 6 6 6 6 15
19 14 14 14 14 14 14 21 6 6 6 6 6 6 6 6 6 15 12 6 6 7 6 15
16 13 13 13 13 13 17 12 6 6 6 6 6 6 6 6 6 15 12 6 6 7 6 15
12 9 9 6 6 6 22 23 6 6 6 6 6 6 6 6 6 15 12 6 6 7 6 15
12 9 9 9 9 6 6 6 6 6 6 6 7 6 6 6 6 22 23 6 6 6 6 15
12 9 9 5 9 9 6 6 6 6 6 6 6 6 6 6 6 6 6 7 6 6 6 15
12 9 9 9 9 9 6 6 6 6 6 6 8 6 6 6 6 6 6 6 6 5 6 15
12 9 9 9 9 6 6 6 6 6 6 5 10 11 6 6 6 6 6 6 6 6 6 15
19 14 14 14 14 14 14 14 14 14 14 14 14 14 14 14 14 14 14 14 14 14 14 18