16 13 13 13 13 13 13 13 13 13 13 13 13 13 13 13 13 13 13 13 13 13 13 13 13 13 13 13 13 13 13 17
12 11 6 5 10 11 11 4 4 10 5 4 11 10 7 6 6 9 10 6 9 8 8 6 6 7 8 5 7 5 7 15
12 4 5 4 7 10 10 6 5 4 5 7 9 6 11 10 9 11 10 10 4 11 10 6 4 4 9 8 10 11 6 15
12 11 10 5 9 4 11 9 4 8 6 6 5 6 11 4 4 6 10 4 11 5 4 6 7 6 11 4 7 6 8 15
12 9 11 5 4 7 8 10 8 8 10 5 7 5 11 7 8 7 5 5 10 9 6 5 11 6 8 7 5 7 5 15
12 6 5 5 5 11 10 8 9 4 5 4 5 7 8 4 8 6 6 11 7 5 5 11 4 6 6 7 5 10 7 15
12 10 10 10 5 5 8 5 8 4 4 4 5 6 5 4 6 7 5 9 9 8 6 6 8 10 9 5 4 6 7 15
12 8 6 7 5 11 9 8 9 11 5 11 11 7 10 10 4 6 8 5 8 7 6 4 8 4 7 5 4 6 8 15
12 6 9 6 5 9 4 4 5 7 6 6 10 11 8 10 5 9 7 10 5 6 11 11 11 8 8 10 11 10 6 15
12 4 7 7 10 5 4 5 4 11 10 8 5 10 6 9 5 7 11 7 9 10 7 4 7 10 7 6 5 6 11 15
12 4 7 9 5 5 5 5 10 10 5 11 5 6 9 5 5 8 7 10 9 7 7 7 9 8 8 5 5 10 9 15
12 5 9 8 7 8 4 11 8 7 7 9 6 10 10 9 10 7 10 4 11 10 6 11 4 10 4 6 6 4 6 15
12 6 7 11 11 11 8 7 10 7 11 7 7 8 5 8 11 9 6 6 4 9 11 4 10 7 6 11 11 11 10 15
12 11 8 5 6 7 7 5 6 11 7 4 6 10 8 4 6 10 8 11 4 10 4 8 7 11 10 11 10 5 11 15
12 4 8 4 9 8 9 11 7 10 8 6 8 9 7 4 5 9 10 11 6 5 10 4 4 9 4 4 8 6 11 15
12 10 11 10 9 11 4 6 5 11 8 5 7 10 8 8 4 5 9 7 11 5 6 4 7 5 4 6 8 7 11 15
12 7 6 8 8 7 6 6 8 9 8 9 5 10 8 11 5 6 4 8 8 10 8 7 5 8 4 6 4 8 10 15
12 8 10 6 10 11 6 10 10 8 7 4 5 5 10 9 11 11 11 6 9 8 6 8 7 4 7 5 8 4 11 15
12 7 9 6 7 8 6 4 5 4 10 7 8 10 5 8 7 8 7 6 5 5 6 11 10 5 10 5 9 10 10 15
12 11 7 5 6 10 9 4 11 5 7 8 9 9 10 4 7 11 5 11 6 8 7 6 5 11 5 11 4 11 7 15
12 11 8 5 10 5 10 6 7 8 5 7 11 8 10 6 9 5 6 4 7 9 8 8 7 5 6 11 9 4 8 15
12 11 8 4 8 6 6 10 5 6 11 7 9 7 8 10 5 4 6 6 5 10 4 11 9 9 4 5 6 9 5 15
12 5 11 9 10 5 5 6 4 8 9 7 5 4 11 5 9 5 5 6 5 11 10 10 7 10 5 9 8 8 8 15
12 5 9 4 6 10 9 8 5 4 10 6 10 4 6 7 8 7 11 4 8 6 11 7 6 7 4 8 9 10 8 15
12 5 7 11 6 4 7 6 11 11 8 4 4 8 11 5 4 11 7 5 10 9 5 9 11 10 11 5 7 4 11 15
12 6 7 9 9 7 7 4 5 9 9 4 4 4 8 11 4 6 4 10 5 8 7 5 11 10 8 10 8 4 9 15
12 10 10 5 7 4 7 8 9 9 4 11 9 7 8 11 7 11 8 8 10 8 11 7 4 5 5 9 10 6 6 15
12 9 10 5 4 6 10 11 6 9 10 6 9 9 5 7 8 9 5 4 8 8 11 6 11 11 4 9 9 8 8 15
12 4 7 4 7 9 6 6 8 9 9 5 6 7 9 6 11 8 7 10 5 7 4 11 11 9 9 10 4 8 7 15
12 7 10 11 6 9 11 6 10 11 10 10 11 7 4 10 4 11 7 6 7 9 6 11 10 7 8 8 4 7 8 15
12 8 9 6 4 7 11 5 8 7 5 10 5 10 5 4 11 6 7 9 8 5 10 6 6 6 9 10 8 10 11 15
19 14 14 14 14 14 14 14 14 14 14 14 14 14 14 14 14 14 14 14 14 14 14 14 14 14 14 14 14 14 14 18
